NO ./textures/walls/army-wall.xpm
SO ./textures/walls/wall1-army.xpm  
WE ./textures/walls/wall2.xpm
EA ./textures/walls/wall2.xpm

F 220,100,0
C 135,206,235

        1111111111111111111111111
        100000000011M0000000000A1
        10110000011100000T0000001
        1001000000000000000000001
111111111D11000001110000000000001
1M000000001100000111D111110111111
11110111111111D11100000010001
11110111111111011101010010001
11000000110101011100T00010T01
10000000000000000D000000D0001
10000000000000001101010010001
11000M01010101011111011110S0111
11110111011101010101111010001
11111111111111111111111111111 