NO ./textures/walls/wall.xpm
SO ./textures/walls/wall1.xpm  
WE ./textures/walls/wall.xpm
EA ./textures/walls/grey.xpm
F 220,100,0
C 135,206,235

1111111
1000001
1011101
1000101
10N0101
1010101
1000001
1111111 